Michele	Leonard
Ora	Pope
Laverne	Erickson
Della	Dennis
Margie	Sanchez
Latoya	Ramirez
Amy	Alexander
Leah	Glover
Marion	Ray
Brent	Munoz
Pat	Morton
Jimmy	Pierce
Kyle	Guerrero
Jason	Edwards
Jack	Peterson
James	Burgess
Malcolm	Vaughn
Brandi	Ballard
Fredrick Abbott
Jeannie	Cook
Vanessa	Chambers
Jennifer Carlson
Lindsey	Briggs
Lowell	Coleman
Terence	Sherman
Antonio	Webster
Lora	Weaver
Lydia	Little
Courtney Watson
Eric	Schmidt
Andrew	Christensen
Kenneth	Kennedy
Donna	Nguyen
Ross	Francis
Daniel	Hampton
Felicia	Norton
Kristy	Bell
Veronica Bridges
Gloria	Vargas
Rose	Summers
Patty	Underwood
Marcella Obrien
Rolando	Garner
Jaime	Adkins
Beth	Palmer
Tony	Maxwell
Reginald Swanson
Sarah	Snyder
Dominick Welch
Jody	Reed